id,name,timestamp,free_bikes,empty_slots,uid,last_updated,slots,normal_bikes,ebikes
023efce1bbb332a1b918d56aeb671890,Avenida de Arteixo,2024-12-12 23:16:22.225000+00:00,4,11,53,1734043481,15,3,1
02cecd02915c86d7ab8034b61b19da0e,Mercado de Monte Alto,2024-12-12 23:16:22.243000+00:00,5,9,43,1734043497,15,1,4
030c4027b0bea390e562645c7082db4c,Los Rosales,2024-12-12 23:16:22.244000+00:00,9,16,11,1734043515,25,3,6
0e3aa0134a2f3d07ae5bd093e6af9a33,Plaza de Portugal,2024-12-12 23:16:22.244000+00:00,4,16,55,1734043594,20,4,0
104e0797759d11ac22a61cfed357800b,Ventorrillo,2024-12-12 23:16:22.245000+00:00,9,9,27,1734043588,18,4,5
10af3b0e504fc241415d4047a58bfb5b,Cd Castrillón,2024-12-12 23:16:22.247000+00:00,9,6,23,1734043540,15,9,0
15b6693701eb534cddabc0bdd4c3b8a2, Pablo Picasso,2024-12-12 23:16:22.247000+00:00,8,11,25,1734043634,19,7,1
16d30b6bb080c9ceac0ab0ca3b20111a,Barrio de las Flores,2024-12-12 23:16:22.248000+00:00,4,19,31,1734043507,23,4,0
18b3d4c21c5cec9d8e25fa0a6cab109a,Torre de Hércules,2024-12-12 23:16:22.250000+00:00,4,11,5,1734043464,15,4,0
18e32269ce7f371acf5ca7f016b07a2a,Campo de Marte,2024-12-12 23:16:22.251000+00:00,10,5,17,1734043551,15,9,1
198820c7b5fc5681e896110c4383a4a0,Hospital Abente y Lago,2024-12-12 23:16:22.251000+00:00,6,9,42,1734043611,15,6,0
1a77b47ff9c828307610737e1a9046c3,Plaza de Tabacos,2024-12-12 23:16:22.252000+00:00,9,10,14,1734043502,19,9,0
1df27d4197c65e404466107444967600,Casa del Agua,2024-12-12 23:16:22.253000+00:00,3,10,57,1734043597,16,3,0
2139f0834a27ab807a5edb3420c2841e,Plaza De Pontevedra,2024-12-12 23:16:22.253000+00:00,8,18,3,1734043482,29,8,0
280380564f13b15dbc782a43d2426689,Estación Autobuses,2024-12-12 23:16:22.254000+00:00,4,11,8,1734043472,15,4,0
2ad08bdfd5fda295855b0297d410716f,Orillamar,2024-12-12 23:16:22.254000+00:00,3,12,40,1734043513,15,1,2
2cdf0b7a087c888dee45f8c619ea5bb2,Aquarium,2024-12-12 23:16:22.255000+00:00,6,8,4,1734043582,15,2,4
2d16841278003915e01f897638776f63,Parque de Oza,2024-12-12 23:16:22.255000+00:00,11,4,49,1734043600,15,11,0
305b3112f5f1083876b2ce9146742596,Aparcamiento Matogrande,2024-12-12 23:16:22.256000+00:00,5,10,15,1734043558,15,4,1
447505d0e57db2f71d7572ceedcbb046,Agrela,2024-12-12 23:16:22.257000+00:00,5,18,28,1734043607,23,5,0
4c0262f67097091b43ca54b09a072bce,Paseo de Los Puentes,2024-12-12 23:16:22.257000+00:00,1,17,20,1734043574,19,1,0
5053bbeb34b876b59c45121ab341af93,Ágora,2024-12-12 23:16:22.258000+00:00,2,21,44,1734043459,23,1,1
5330f247a28be53b762427542867dd73,Campo de La Leña (Plaza De España),2024-12-12 23:16:22.258000+00:00,7,8,18,1734043465,15,7,0
7446dcc290f2570a47d4ed2bc9282ceb,Cuatro Caminos,2024-12-12 23:16:22.259000+00:00,18,5,50,1734043618,23,18,0
75e54fb28a5679603047bbd282047916,Puerto - Palexco,2024-12-12 23:16:22.259000+00:00,5,10,6,1734043463,15,5,0
88a676510bd52100c911fb1a9b5f87b4,Expocoruna,2024-12-12 23:16:22.260000+00:00,1,18,33,1734043592,19,0,1
8c078d095787b97917c07ab40bf3594e,Plaza Recife,2024-12-12 23:16:22.260000+00:00,11,3,47,1734043494,15,11,0
8dfd4b95e7f499296e03312c5b1f9e22,Plaza de San Rosendo,2024-12-12 23:16:22.261000+00:00,3,11,19,1734043604,15,1,2
938a003c099dc9b2c7411f2000b88022,Puerta Real,2024-12-12 23:16:22.262000+00:00,6,16,22,1734043629,23,6,0
95a1abdf86ec8d29deb7380938c2e02e,Plaza de Conchiñas,2024-12-12 23:16:22.262000+00:00,4,11,12,1734043551,15,0,4
9ba72d8f143fb690546e6950b2d53c97,Estación Tren,2024-12-12 23:16:22.262000+00:00,7,8,9,1734043524,15,7,0
9e7f93baecab42d934a507a9ef7e5938,Adormideras,2024-12-12 23:16:22.263000+00:00,10,9,26,1734043558,19,6,4
9e84dc079b6d308cb74dedeb0f98f345,Marineda,2024-12-12 23:16:22.264000+00:00,0,21,29,1734043527,23,0,0
a2893fa94f1de9a32b0b210b994f3e10,Parque de Santa Margarita,2024-12-12 23:16:22.264000+00:00,11,2,54,1734043499,13,5,6
a876e4f21fbf7e9873b395485d080c1f,Ciudad Escolar,2024-12-12 23:16:22.265000+00:00,8,11,36,1734043490,19,8,0
b376679bc7b9464f8f0edc775d71d5ad,Parque de Eirís,2024-12-12 23:16:22.265000+00:00,9,10,32,1734043547,19,7,2
b55aa9b4a84ef790d95fe5c43e4bd1ad,Novo Mesoiro,2024-12-12 23:16:22.266000+00:00,2,21,30,1734043596,23,0,2
bf735b3d92053c97f825a333f6686aac,Chuac,2024-12-12 23:16:22.266000+00:00,6,13,51,1734043637,19,5,1
c158d9e1e35d2323bb2bbf49da32c47b,Casa de Sol,2024-12-12 23:16:22.267000+00:00,4,12,16,1734043562,16,2,2
cc7469fb9362066706da43aafbe02e1f,Centro deportivo Elviña,2024-12-12 23:16:22.267000+00:00,0,19,52,1734043593,19,0,0
d03cf3099b20bc41dddaf4ee8b282dfa,Maestranza,2024-12-12 23:16:22.268000+00:00,6,13,35,1734043630,19,6,0
d9b01b13fb85506d591617ab5e8cf4bc,Mirador de los Castros,2024-12-12 23:16:22.268000+00:00,1,18,10,1734043565,19,1,0
daa753bf3bdb6d5b722734d126b843b1,Plaza de Vigo,2024-12-12 23:16:22.269000+00:00,6,10,13,1734043587,19,5,1
e97735d79704dc080f7ee1a2af1e402f,Obelisco,2024-12-12 23:16:22.269000+00:00,7,16,7,1734043553,23,7,0
f04ee4ffca2a6f3daacba88a9eee8487,Millenium,2024-12-12 23:16:22.269000+00:00,6,9,56,1734043584,15,6,0
f702a7b2b1631ace3781c405acb99b70,Praza de Ourense,2024-12-12 23:16:22.270000+00:00,5,8,41,1734043571,15,5,0
f86954a7b51703f735bce5b549cb4e16,Parque del Agra,2024-12-12 23:16:22.270000+00:00,7,8,45,1734043600,15,1,6
fb0d3f40ea7570546b171b43ccd57a2a,Rosales-Labañou,2024-12-12 23:16:22.271000+00:00,6,8,46,1734043584,15,5,1
fee1ae73b32ffb83e1bf3f6e83e616b7,Centro Cívico Monelos,2024-12-12 23:16:22.271000+00:00,7,8,21,1734043606,15,7,0
023efce1bbb332a1b918d56aeb671890,Avenida de Arteixo,2024-12-12 23:20:25.150000+00:00,2,13,53,1734045323,15,2,0
02cecd02915c86d7ab8034b61b19da0e,Mercado de Monte Alto,2024-12-12 23:20:25.152000+00:00,6,8,43,1734045322,15,1,5
030c4027b0bea390e562645c7082db4c,Los Rosales,2024-12-12 23:20:25.153000+00:00,10,15,11,1734045348,25,3,7
0e3aa0134a2f3d07ae5bd093e6af9a33,Plaza de Portugal,2024-12-12 23:20:25.153000+00:00,3,17,55,1734045425,20,3,0
104e0797759d11ac22a61cfed357800b,Ventorrillo,2024-12-12 23:20:25.154000+00:00,8,10,27,1734045395,18,4,4
10af3b0e504fc241415d4047a58bfb5b,Cd Castrillón,2024-12-12 23:20:25.154000+00:00,9,6,23,1734045370,15,9,0
15b6693701eb534cddabc0bdd4c3b8a2, Pablo Picasso,2024-12-12 23:20:25.155000+00:00,9,10,25,1734045276,19,8,1
16d30b6bb080c9ceac0ab0ca3b20111a,Barrio de las Flores,2024-12-12 23:20:25.155000+00:00,5,18,31,1734045336,23,5,0
18b3d4c21c5cec9d8e25fa0a6cab109a,Torre de Hércules,2024-12-12 23:20:25.156000+00:00,4,11,5,1734045297,15,4,0
18e32269ce7f371acf5ca7f016b07a2a,Campo de Marte,2024-12-12 23:20:25.157000+00:00,11,4,17,1734045382,15,9,2
198820c7b5fc5681e896110c4383a4a0,Hospital Abente y Lago,2024-12-12 23:20:25.157000+00:00,6,9,42,1734045261,15,6,0
1a77b47ff9c828307610737e1a9046c3,Plaza de Tabacos,2024-12-12 23:20:25.158000+00:00,14,5,14,1734045342,19,13,1
1df27d4197c65e404466107444967600,Casa del Agua,2024-12-12 23:20:25.159000+00:00,3,10,57,1734045427,16,3,0
2139f0834a27ab807a5edb3420c2841e,Plaza De Pontevedra,2024-12-12 23:20:25.159000+00:00,11,15,3,1734045299,29,11,0
280380564f13b15dbc782a43d2426689,Estación Autobuses,2024-12-12 23:20:25.160000+00:00,6,9,8,1734045308,15,5,1
2ad08bdfd5fda295855b0297d410716f,Orillamar,2024-12-12 23:20:25.161000+00:00,3,12,40,1734045343,15,1,2
2cdf0b7a087c888dee45f8c619ea5bb2,Aquarium,2024-12-12 23:20:25.162000+00:00,5,9,4,1734045416,15,2,3
2d16841278003915e01f897638776f63,Parque de Oza,2024-12-12 23:20:25.162000+00:00,10,5,49,1734045435,15,10,0
305b3112f5f1083876b2ce9146742596,Aparcamiento Matogrande,2024-12-12 23:20:25.163000+00:00,4,11,15,1734045393,15,4,0
447505d0e57db2f71d7572ceedcbb046,Agrela,2024-12-12 23:20:25.164000+00:00,5,18,28,1734045440,23,5,0
4c0262f67097091b43ca54b09a072bce,Paseo de Los Puentes,2024-12-12 23:20:25.165000+00:00,1,17,20,1734045404,19,1,0
5053bbeb34b876b59c45121ab341af93,Ágora,2024-12-12 23:20:25.166000+00:00,5,18,44,1734045291,23,1,4
5330f247a28be53b762427542867dd73,Campo de La Leña (Plaza De España),2024-12-12 23:20:25.167000+00:00,7,8,18,1734045303,15,7,0
7446dcc290f2570a47d4ed2bc9282ceb,Cuatro Caminos,2024-12-12 23:20:25.168000+00:00,17,6,50,1734045263,23,17,0
75e54fb28a5679603047bbd282047916,Puerto - Palexco,2024-12-12 23:20:25.168000+00:00,6,9,6,1734045293,15,6,0
88a676510bd52100c911fb1a9b5f87b4,Expocoruna,2024-12-12 23:20:25.169000+00:00,2,17,33,1734045421,19,1,1
8c078d095787b97917c07ab40bf3594e,Plaza Recife,2024-12-12 23:20:25.171000+00:00,11,3,47,1734045331,15,11,0
8dfd4b95e7f499296e03312c5b1f9e22,Plaza de San Rosendo,2024-12-12 23:20:25.172000+00:00,4,10,19,1734045433,15,1,3
938a003c099dc9b2c7411f2000b88022,Puerta Real,2024-12-12 23:20:25.172000+00:00,6,16,22,1734045281,23,6,0
95a1abdf86ec8d29deb7380938c2e02e,Plaza de Conchiñas,2024-12-12 23:20:25.173000+00:00,3,12,12,1734045383,15,1,2
9ba72d8f143fb690546e6950b2d53c97,Estación Tren,2024-12-12 23:20:25.173000+00:00,6,9,9,1734045356,15,6,0
9e7f93baecab42d934a507a9ef7e5938,Adormideras,2024-12-12 23:20:25.174000+00:00,10,9,26,1734045388,19,6,4
9e84dc079b6d308cb74dedeb0f98f345,Marineda,2024-12-12 23:20:25.174000+00:00,0,21,29,1734045367,23,0,0
a2893fa94f1de9a32b0b210b994f3e10,Parque de Santa Margarita,2024-12-12 23:20:25.175000+00:00,7,6,54,1734045330,13,5,2
a876e4f21fbf7e9873b395485d080c1f,Ciudad Escolar,2024-12-12 23:20:25.176000+00:00,9,10,36,1734045322,19,7,2
b376679bc7b9464f8f0edc775d71d5ad,Parque de Eirís,2024-12-12 23:20:25.176000+00:00,11,8,32,1734045375,19,7,4
b55aa9b4a84ef790d95fe5c43e4bd1ad,Novo Mesoiro,2024-12-12 23:20:25.177000+00:00,2,21,30,1734045429,23,0,2
bf735b3d92053c97f825a333f6686aac,Chuac,2024-12-12 23:20:25.177000+00:00,6,13,51,1734045287,19,5,1
c158d9e1e35d2323bb2bbf49da32c47b,Casa de Sol,2024-12-12 23:20:25.178000+00:00,3,13,16,1734045387,16,3,0
cc7469fb9362066706da43aafbe02e1f,Centro deportivo Elviña,2024-12-12 23:20:25.179000+00:00,0,19,52,1734045420,19,0,0
d03cf3099b20bc41dddaf4ee8b282dfa,Maestranza,2024-12-12 23:20:25.179000+00:00,6,13,35,1734045278,19,6,0
d9b01b13fb85506d591617ab5e8cf4bc,Mirador de los Castros,2024-12-12 23:20:25.180000+00:00,3,16,10,1734045410,19,3,0
daa753bf3bdb6d5b722734d126b843b1,Plaza de Vigo,2024-12-12 23:20:25.181000+00:00,5,11,13,1734045424,19,5,0
e97735d79704dc080f7ee1a2af1e402f,Obelisco,2024-12-12 23:20:25.181000+00:00,8,15,7,1734045389,23,8,0
f04ee4ffca2a6f3daacba88a9eee8487,Millenium,2024-12-12 23:20:25.182000+00:00,7,8,56,1734045417,15,7,0
f702a7b2b1631ace3781c405acb99b70,Praza de Ourense,2024-12-12 23:20:25.183000+00:00,5,8,41,1734045401,15,5,0
f86954a7b51703f735bce5b549cb4e16,Parque del Agra,2024-12-12 23:20:25.183000+00:00,7,8,45,1734045435,15,1,6
fb0d3f40ea7570546b171b43ccd57a2a,Rosales-Labañou,2024-12-12 23:20:25.184000+00:00,6,8,46,1734045419,15,5,1
fee1ae73b32ffb83e1bf3f6e83e616b7,Centro Cívico Monelos,2024-12-12 23:20:25.185000+00:00,9,6,21,1734045436,15,8,1
023efce1bbb332a1b918d56aeb671890,Avenida de Arteixo,2024-12-12 23:21:27.278000+00:00,2,13,53,1734045507,15,2,0
02cecd02915c86d7ab8034b61b19da0e,Mercado de Monte Alto,2024-12-12 23:21:27.280000+00:00,7,7,43,1734045503,15,1,6
030c4027b0bea390e562645c7082db4c,Los Rosales,2024-12-12 23:21:27.281000+00:00,10,15,11,1734045532,25,3,7
0e3aa0134a2f3d07ae5bd093e6af9a33,Plaza de Portugal,2024-12-12 23:21:27.281000+00:00,3,17,55,1734045609,20,3,0
104e0797759d11ac22a61cfed357800b,Ventorrillo,2024-12-12 23:21:27.282000+00:00,8,10,27,1734045576,18,4,4
10af3b0e504fc241415d4047a58bfb5b,Cd Castrillón,2024-12-12 23:21:27.282000+00:00,9,6,23,1734045553,15,9,0
15b6693701eb534cddabc0bdd4c3b8a2, Pablo Picasso,2024-12-12 23:21:27.283000+00:00,9,10,25,1734045457,19,8,1
16d30b6bb080c9ceac0ab0ca3b20111a,Barrio de las Flores,2024-12-12 23:21:27.283000+00:00,5,18,31,1734045517,23,5,0
18b3d4c21c5cec9d8e25fa0a6cab109a,Torre de Hércules,2024-12-12 23:21:27.284000+00:00,4,11,5,1734045486,15,4,0
18e32269ce7f371acf5ca7f016b07a2a,Campo de Marte,2024-12-12 23:21:27.284000+00:00,11,4,17,1734045565,15,9,2
198820c7b5fc5681e896110c4383a4a0,Hospital Abente y Lago,2024-12-12 23:21:27.284000+00:00,6,9,42,1734045444,15,6,0
1a77b47ff9c828307610737e1a9046c3,Plaza de Tabacos,2024-12-12 23:21:27.285000+00:00,14,5,14,1734045526,19,13,1
1df27d4197c65e404466107444967600,Casa del Agua,2024-12-12 23:21:27.285000+00:00,3,10,57,1734045609,16,3,0
2139f0834a27ab807a5edb3420c2841e,Plaza De Pontevedra,2024-12-12 23:21:27.286000+00:00,12,14,3,1734045482,29,12,0
280380564f13b15dbc782a43d2426689,Estación Autobuses,2024-12-12 23:21:27.286000+00:00,6,9,8,1734045492,15,5,1
2ad08bdfd5fda295855b0297d410716f,Orillamar,2024-12-12 23:21:27.287000+00:00,3,12,40,1734045527,15,1,2
2cdf0b7a087c888dee45f8c619ea5bb2,Aquarium,2024-12-12 23:21:27.287000+00:00,5,9,4,1734045600,15,2,3
2d16841278003915e01f897638776f63,Parque de Oza,2024-12-12 23:21:27.288000+00:00,10,5,49,1734045619,15,10,0
305b3112f5f1083876b2ce9146742596,Aparcamiento Matogrande,2024-12-12 23:21:27.288000+00:00,4,11,15,1734045576,15,4,0
447505d0e57db2f71d7572ceedcbb046,Agrela,2024-12-12 23:21:27.289000+00:00,5,18,28,1734045440,23,5,0
4c0262f67097091b43ca54b09a072bce,Paseo de Los Puentes,2024-12-12 23:21:27.289000+00:00,1,17,20,1734045588,19,1,0
5053bbeb34b876b59c45121ab341af93,Ágora,2024-12-12 23:21:27.290000+00:00,5,18,44,1734045476,23,1,4
5330f247a28be53b762427542867dd73,Campo de La Leña (Plaza De España),2024-12-12 23:21:27.290000+00:00,7,8,18,1734045487,15,7,0
7446dcc290f2570a47d4ed2bc9282ceb,Cuatro Caminos,2024-12-12 23:21:27.290000+00:00,17,6,50,1734045446,23,17,0
75e54fb28a5679603047bbd282047916,Puerto - Palexco,2024-12-12 23:21:27.291000+00:00,7,8,6,1734045477,15,6,1
88a676510bd52100c911fb1a9b5f87b4,Expocoruna,2024-12-12 23:21:27.291000+00:00,2,17,33,1734045602,19,1,1
8c078d095787b97917c07ab40bf3594e,Plaza Recife,2024-12-12 23:21:27.292000+00:00,11,3,47,1734045514,15,11,0
8dfd4b95e7f499296e03312c5b1f9e22,Plaza de San Rosendo,2024-12-12 23:21:27.292000+00:00,3,11,19,1734045616,15,1,2
938a003c099dc9b2c7411f2000b88022,Puerta Real,2024-12-12 23:21:27.293000+00:00,6,16,22,1734045465,23,6,0
95a1abdf86ec8d29deb7380938c2e02e,Plaza de Conchiñas,2024-12-12 23:21:27.293000+00:00,4,11,12,1734045568,15,1,3
9ba72d8f143fb690546e6950b2d53c97,Estación Tren,2024-12-12 23:21:27.293000+00:00,6,9,9,1734045539,15,6,0
9e7f93baecab42d934a507a9ef7e5938,Adormideras,2024-12-12 23:21:27.294000+00:00,10,9,26,1734045571,19,6,4
9e84dc079b6d308cb74dedeb0f98f345,Marineda,2024-12-12 23:21:27.295000+00:00,0,21,29,1734045551,23,0,0
a2893fa94f1de9a32b0b210b994f3e10,Parque de Santa Margarita,2024-12-12 23:21:27.295000+00:00,7,6,54,1734045513,13,5,2
a876e4f21fbf7e9873b395485d080c1f,Ciudad Escolar,2024-12-12 23:21:27.296000+00:00,10,9,36,1734045506,19,7,3
b376679bc7b9464f8f0edc775d71d5ad,Parque de Eirís,2024-12-12 23:21:27.296000+00:00,11,8,32,1734045558,19,7,4
b55aa9b4a84ef790d95fe5c43e4bd1ad,Novo Mesoiro,2024-12-12 23:21:27.297000+00:00,2,21,30,1734045611,23,0,2
bf735b3d92053c97f825a333f6686aac,Chuac,2024-12-12 23:21:27.297000+00:00,6,13,51,1734045471,19,5,1
c158d9e1e35d2323bb2bbf49da32c47b,Casa de Sol,2024-12-12 23:21:27.298000+00:00,2,14,16,1734045569,16,2,0
cc7469fb9362066706da43aafbe02e1f,Centro deportivo Elviña,2024-12-12 23:21:27.298000+00:00,0,19,52,1734045603,19,0,0
d03cf3099b20bc41dddaf4ee8b282dfa,Maestranza,2024-12-12 23:21:27.299000+00:00,6,13,35,1734045463,19,6,0
d9b01b13fb85506d591617ab5e8cf4bc,Mirador de los Castros,2024-12-12 23:21:27.299000+00:00,3,16,10,1734045593,19,3,0
daa753bf3bdb6d5b722734d126b843b1,Plaza de Vigo,2024-12-12 23:21:27.300000+00:00,5,11,13,1734045607,19,5,0
e97735d79704dc080f7ee1a2af1e402f,Obelisco,2024-12-12 23:21:27.300000+00:00,7,16,7,1734045573,23,7,0
f04ee4ffca2a6f3daacba88a9eee8487,Millenium,2024-12-12 23:21:27.301000+00:00,7,8,56,1734045601,15,7,0
f702a7b2b1631ace3781c405acb99b70,Praza de Ourense,2024-12-12 23:21:27.301000+00:00,5,8,41,1734045585,15,5,0
f86954a7b51703f735bce5b549cb4e16,Parque del Agra,2024-12-12 23:21:27.302000+00:00,7,8,45,1734045618,15,1,6
fb0d3f40ea7570546b171b43ccd57a2a,Rosales-Labañou,2024-12-12 23:21:27.302000+00:00,6,8,46,1734045603,15,5,1
fee1ae73b32ffb83e1bf3f6e83e616b7,Centro Cívico Monelos,2024-12-12 23:21:27.303000+00:00,9,6,21,1734045619,15,8,1
023efce1bbb332a1b918d56aeb671890,Avenida de Arteixo,2024-12-12 23:22:15.389000+00:00,2,13,53,1734045507,15,2,0
02cecd02915c86d7ab8034b61b19da0e,Mercado de Monte Alto,2024-12-12 23:22:15.391000+00:00,7,7,43,1734045503,15,1,6
030c4027b0bea390e562645c7082db4c,Los Rosales,2024-12-12 23:22:15.392000+00:00,10,15,11,1734045532,25,3,7
0e3aa0134a2f3d07ae5bd093e6af9a33,Plaza de Portugal,2024-12-12 23:22:15.392000+00:00,3,17,55,1734045609,20,3,0
104e0797759d11ac22a61cfed357800b,Ventorrillo,2024-12-12 23:22:15.393000+00:00,8,10,27,1734045576,18,4,4
10af3b0e504fc241415d4047a58bfb5b,Cd Castrillón,2024-12-12 23:22:15.393000+00:00,9,6,23,1734045553,15,9,0
15b6693701eb534cddabc0bdd4c3b8a2, Pablo Picasso,2024-12-12 23:22:15.393000+00:00,9,10,25,1734045457,19,8,1
16d30b6bb080c9ceac0ab0ca3b20111a,Barrio de las Flores,2024-12-12 23:22:15.394000+00:00,5,18,31,1734045517,23,5,0
18b3d4c21c5cec9d8e25fa0a6cab109a,Torre de Hércules,2024-12-12 23:22:15.394000+00:00,4,11,5,1734045486,15,4,0
18e32269ce7f371acf5ca7f016b07a2a,Campo de Marte,2024-12-12 23:22:15.395000+00:00,11,4,17,1734045565,15,9,2
198820c7b5fc5681e896110c4383a4a0,Hospital Abente y Lago,2024-12-12 23:22:15.396000+00:00,6,9,42,1734045444,15,6,0
1a77b47ff9c828307610737e1a9046c3,Plaza de Tabacos,2024-12-12 23:22:15.396000+00:00,14,5,14,1734045526,19,13,1
1df27d4197c65e404466107444967600,Casa del Agua,2024-12-12 23:22:15.397000+00:00,3,10,57,1734045609,16,3,0
2139f0834a27ab807a5edb3420c2841e,Plaza De Pontevedra,2024-12-12 23:22:15.397000+00:00,12,14,3,1734045482,29,12,0
280380564f13b15dbc782a43d2426689,Estación Autobuses,2024-12-12 23:22:15.397000+00:00,6,9,8,1734045492,15,5,1
2ad08bdfd5fda295855b0297d410716f,Orillamar,2024-12-12 23:22:15.398000+00:00,3,12,40,1734045527,15,1,2
2cdf0b7a087c888dee45f8c619ea5bb2,Aquarium,2024-12-12 23:22:15.398000+00:00,5,9,4,1734045600,15,2,3
2d16841278003915e01f897638776f63,Parque de Oza,2024-12-12 23:22:15.399000+00:00,10,5,49,1734045619,15,10,0
305b3112f5f1083876b2ce9146742596,Aparcamiento Matogrande,2024-12-12 23:22:15.400000+00:00,4,11,15,1734045576,15,4,0
447505d0e57db2f71d7572ceedcbb046,Agrela,2024-12-12 23:22:15.400000+00:00,5,18,28,1734045440,23,5,0
4c0262f67097091b43ca54b09a072bce,Paseo de Los Puentes,2024-12-12 23:22:15.401000+00:00,1,17,20,1734045588,19,1,0
5053bbeb34b876b59c45121ab341af93,Ágora,2024-12-12 23:22:15.401000+00:00,5,18,44,1734045476,23,1,4
5330f247a28be53b762427542867dd73,Campo de La Leña (Plaza De España),2024-12-12 23:22:15.402000+00:00,7,8,18,1734045487,15,7,0
7446dcc290f2570a47d4ed2bc9282ceb,Cuatro Caminos,2024-12-12 23:22:15.402000+00:00,17,6,50,1734045446,23,17,0
75e54fb28a5679603047bbd282047916,Puerto - Palexco,2024-12-12 23:22:15.402000+00:00,7,8,6,1734045477,15,6,1
88a676510bd52100c911fb1a9b5f87b4,Expocoruna,2024-12-12 23:22:15.403000+00:00,2,17,33,1734045602,19,1,1
8c078d095787b97917c07ab40bf3594e,Plaza Recife,2024-12-12 23:22:15.403000+00:00,11,3,47,1734045514,15,11,0
8dfd4b95e7f499296e03312c5b1f9e22,Plaza de San Rosendo,2024-12-12 23:22:15.404000+00:00,3,11,19,1734045616,15,1,2
938a003c099dc9b2c7411f2000b88022,Puerta Real,2024-12-12 23:22:15.404000+00:00,6,16,22,1734045465,23,6,0
95a1abdf86ec8d29deb7380938c2e02e,Plaza de Conchiñas,2024-12-12 23:22:15.404000+00:00,4,11,12,1734045568,15,1,3
9ba72d8f143fb690546e6950b2d53c97,Estación Tren,2024-12-12 23:22:15.405000+00:00,6,9,9,1734045539,15,6,0
9e7f93baecab42d934a507a9ef7e5938,Adormideras,2024-12-12 23:22:15.405000+00:00,10,9,26,1734045571,19,6,4
9e84dc079b6d308cb74dedeb0f98f345,Marineda,2024-12-12 23:22:15.406000+00:00,0,21,29,1734045551,23,0,0
a2893fa94f1de9a32b0b210b994f3e10,Parque de Santa Margarita,2024-12-12 23:22:15.406000+00:00,7,6,54,1734045513,13,5,2
a876e4f21fbf7e9873b395485d080c1f,Ciudad Escolar,2024-12-12 23:22:15.407000+00:00,10,9,36,1734045506,19,7,3
b376679bc7b9464f8f0edc775d71d5ad,Parque de Eirís,2024-12-12 23:22:15.407000+00:00,11,8,32,1734045558,19,7,4
b55aa9b4a84ef790d95fe5c43e4bd1ad,Novo Mesoiro,2024-12-12 23:22:15.407000+00:00,2,21,30,1734045611,23,0,2
bf735b3d92053c97f825a333f6686aac,Chuac,2024-12-12 23:22:15.408000+00:00,6,13,51,1734045471,19,5,1
c158d9e1e35d2323bb2bbf49da32c47b,Casa de Sol,2024-12-12 23:22:15.408000+00:00,2,14,16,1734045569,16,2,0
cc7469fb9362066706da43aafbe02e1f,Centro deportivo Elviña,2024-12-12 23:22:15.409000+00:00,0,19,52,1734045603,19,0,0
d03cf3099b20bc41dddaf4ee8b282dfa,Maestranza,2024-12-12 23:22:15.409000+00:00,6,13,35,1734045463,19,6,0
d9b01b13fb85506d591617ab5e8cf4bc,Mirador de los Castros,2024-12-12 23:22:15.409000+00:00,3,16,10,1734045593,19,3,0
daa753bf3bdb6d5b722734d126b843b1,Plaza de Vigo,2024-12-12 23:22:15.410000+00:00,5,11,13,1734045607,19,5,0
e97735d79704dc080f7ee1a2af1e402f,Obelisco,2024-12-12 23:22:15.411000+00:00,7,16,7,1734045573,23,7,0
f04ee4ffca2a6f3daacba88a9eee8487,Millenium,2024-12-12 23:22:15.411000+00:00,7,8,56,1734045601,15,7,0
f702a7b2b1631ace3781c405acb99b70,Praza de Ourense,2024-12-12 23:22:15.412000+00:00,5,8,41,1734045585,15,5,0
f86954a7b51703f735bce5b549cb4e16,Parque del Agra,2024-12-12 23:22:15.412000+00:00,7,8,45,1734045618,15,1,6
fb0d3f40ea7570546b171b43ccd57a2a,Rosales-Labañou,2024-12-12 23:22:15.412000+00:00,6,8,46,1734045603,15,5,1
fee1ae73b32ffb83e1bf3f6e83e616b7,Centro Cívico Monelos,2024-12-12 23:22:15.413000+00:00,9,6,21,1734045619,15,8,1
023efce1bbb332a1b918d56aeb671890,Avenida de Arteixo,2024-12-12 23:23:21.019000+00:00,2,13,53,1734045507,15,2,0
02cecd02915c86d7ab8034b61b19da0e,Mercado de Monte Alto,2024-12-12 23:23:21.020000+00:00,7,7,43,1734045503,15,1,6
030c4027b0bea390e562645c7082db4c,Los Rosales,2024-12-12 23:23:21.020000+00:00,10,15,11,1734045532,25,3,7
0e3aa0134a2f3d07ae5bd093e6af9a33,Plaza de Portugal,2024-12-12 23:23:21.021000+00:00,3,17,55,1734045609,20,3,0
104e0797759d11ac22a61cfed357800b,Ventorrillo,2024-12-12 23:23:21.021000+00:00,8,10,27,1734045576,18,4,4
10af3b0e504fc241415d4047a58bfb5b,Cd Castrillón,2024-12-12 23:23:21.021000+00:00,9,6,23,1734045553,15,9,0
15b6693701eb534cddabc0bdd4c3b8a2, Pablo Picasso,2024-12-12 23:23:21.022000+00:00,9,10,25,1734045457,19,8,1
16d30b6bb080c9ceac0ab0ca3b20111a,Barrio de las Flores,2024-12-12 23:23:21.022000+00:00,5,18,31,1734045517,23,5,0
18b3d4c21c5cec9d8e25fa0a6cab109a,Torre de Hércules,2024-12-12 23:23:21.023000+00:00,4,11,5,1734045486,15,4,0
18e32269ce7f371acf5ca7f016b07a2a,Campo de Marte,2024-12-12 23:23:21.023000+00:00,11,4,17,1734045565,15,9,2
198820c7b5fc5681e896110c4383a4a0,Hospital Abente y Lago,2024-12-12 23:23:21.024000+00:00,6,9,42,1734045444,15,6,0
1a77b47ff9c828307610737e1a9046c3,Plaza de Tabacos,2024-12-12 23:23:21.024000+00:00,14,5,14,1734045526,19,13,1
1df27d4197c65e404466107444967600,Casa del Agua,2024-12-12 23:23:21.024000+00:00,3,10,57,1734045609,16,3,0
2139f0834a27ab807a5edb3420c2841e,Plaza De Pontevedra,2024-12-12 23:23:21.025000+00:00,12,14,3,1734045482,29,12,0
280380564f13b15dbc782a43d2426689,Estación Autobuses,2024-12-12 23:23:21.025000+00:00,6,9,8,1734045492,15,5,1
2ad08bdfd5fda295855b0297d410716f,Orillamar,2024-12-12 23:23:21.026000+00:00,3,12,40,1734045527,15,1,2
2cdf0b7a087c888dee45f8c619ea5bb2,Aquarium,2024-12-12 23:23:21.026000+00:00,5,9,4,1734045600,15,2,3
2d16841278003915e01f897638776f63,Parque de Oza,2024-12-12 23:23:21.027000+00:00,10,5,49,1734045619,15,10,0
305b3112f5f1083876b2ce9146742596,Aparcamiento Matogrande,2024-12-12 23:23:21.027000+00:00,4,11,15,1734045576,15,4,0
447505d0e57db2f71d7572ceedcbb046,Agrela,2024-12-12 23:23:21.028000+00:00,5,18,28,1734045440,23,5,0
4c0262f67097091b43ca54b09a072bce,Paseo de Los Puentes,2024-12-12 23:23:21.028000+00:00,1,17,20,1734045588,19,1,0
5053bbeb34b876b59c45121ab341af93,Ágora,2024-12-12 23:23:21.029000+00:00,5,18,44,1734045476,23,1,4
5330f247a28be53b762427542867dd73,Campo de La Leña (Plaza De España),2024-12-12 23:23:21.029000+00:00,7,8,18,1734045487,15,7,0
7446dcc290f2570a47d4ed2bc9282ceb,Cuatro Caminos,2024-12-12 23:23:21.030000+00:00,17,6,50,1734045446,23,17,0
75e54fb28a5679603047bbd282047916,Puerto - Palexco,2024-12-12 23:23:21.030000+00:00,7,8,6,1734045477,15,6,1
88a676510bd52100c911fb1a9b5f87b4,Expocoruna,2024-12-12 23:23:21.031000+00:00,2,17,33,1734045602,19,1,1
8c078d095787b97917c07ab40bf3594e,Plaza Recife,2024-12-12 23:23:21.031000+00:00,11,3,47,1734045514,15,11,0
8dfd4b95e7f499296e03312c5b1f9e22,Plaza de San Rosendo,2024-12-12 23:23:21.031000+00:00,3,11,19,1734045616,15,1,2
938a003c099dc9b2c7411f2000b88022,Puerta Real,2024-12-12 23:23:21.032000+00:00,6,16,22,1734045465,23,6,0
95a1abdf86ec8d29deb7380938c2e02e,Plaza de Conchiñas,2024-12-12 23:23:21.032000+00:00,4,11,12,1734045568,15,1,3
9ba72d8f143fb690546e6950b2d53c97,Estación Tren,2024-12-12 23:23:21.033000+00:00,6,9,9,1734045539,15,6,0
9e7f93baecab42d934a507a9ef7e5938,Adormideras,2024-12-12 23:23:21.033000+00:00,10,9,26,1734045571,19,6,4
9e84dc079b6d308cb74dedeb0f98f345,Marineda,2024-12-12 23:23:21.033000+00:00,0,21,29,1734045551,23,0,0
a2893fa94f1de9a32b0b210b994f3e10,Parque de Santa Margarita,2024-12-12 23:23:21.034000+00:00,7,6,54,1734045513,13,5,2
a876e4f21fbf7e9873b395485d080c1f,Ciudad Escolar,2024-12-12 23:23:21.035000+00:00,10,9,36,1734045506,19,7,3
b376679bc7b9464f8f0edc775d71d5ad,Parque de Eirís,2024-12-12 23:23:21.035000+00:00,11,8,32,1734045558,19,7,4
b55aa9b4a84ef790d95fe5c43e4bd1ad,Novo Mesoiro,2024-12-12 23:23:21.036000+00:00,2,21,30,1734045611,23,0,2
bf735b3d92053c97f825a333f6686aac,Chuac,2024-12-12 23:23:21.036000+00:00,6,13,51,1734045471,19,5,1
c158d9e1e35d2323bb2bbf49da32c47b,Casa de Sol,2024-12-12 23:23:21.036000+00:00,2,14,16,1734045569,16,2,0
cc7469fb9362066706da43aafbe02e1f,Centro deportivo Elviña,2024-12-12 23:23:21.037000+00:00,0,19,52,1734045603,19,0,0
d03cf3099b20bc41dddaf4ee8b282dfa,Maestranza,2024-12-12 23:23:21.037000+00:00,6,13,35,1734045463,19,6,0
d9b01b13fb85506d591617ab5e8cf4bc,Mirador de los Castros,2024-12-12 23:23:21.038000+00:00,3,16,10,1734045593,19,3,0
daa753bf3bdb6d5b722734d126b843b1,Plaza de Vigo,2024-12-12 23:23:21.038000+00:00,5,11,13,1734045607,19,5,0
e97735d79704dc080f7ee1a2af1e402f,Obelisco,2024-12-12 23:23:21.039000+00:00,7,16,7,1734045573,23,7,0
f04ee4ffca2a6f3daacba88a9eee8487,Millenium,2024-12-12 23:23:21.039000+00:00,7,8,56,1734045601,15,7,0
f702a7b2b1631ace3781c405acb99b70,Praza de Ourense,2024-12-12 23:23:21.040000+00:00,5,8,41,1734045585,15,5,0
f86954a7b51703f735bce5b549cb4e16,Parque del Agra,2024-12-12 23:23:21.040000+00:00,7,8,45,1734045618,15,1,6
fb0d3f40ea7570546b171b43ccd57a2a,Rosales-Labañou,2024-12-12 23:23:21.040000+00:00,6,8,46,1734045603,15,5,1
fee1ae73b32ffb83e1bf3f6e83e616b7,Centro Cívico Monelos,2024-12-12 23:23:21.041000+00:00,9,6,21,1734045619,15,8,1
